11111111
100P1C01
101111E1
100C0001
11111101
1C000001
11111111