11111111111111
1P1E0000R000C1
10111111010111
101C00010101C1

10001001110101
1000100Q000001
10011110111001
10000R00100001
1000C00010C001
11111111111111