11111111111111
1P1E0000R000C1
10111111010111
101C000101P1C1
10001001110101
1000100Q0000011
10011110111001
10000R00100001
1000C00010C001
11111111111111