11111111
100P1E01
101111C1
100C0001
11111101
1C000001
11111111