11111111111111
1P1E00000000C1
10111111010111
101C00010101C1
10001001110101
10001000000001
10011110111001
10000000100001
1000C00010C001
11111111111111