111111111111
1PCCCCCCCCC1
1011111111C1
1010000001C1
1R1000Q001C1
1010R00001C1
1010000001C1
1011111111C1
1000000000E1
111111111111