11111111111111111111
1P1C0000000000000001
10101111111110111101
10101000001R00101001
10111011101011101011
10100010101000001001
10101110101111111101
100C10001Q0010001001
11111011111010101011
100000100010101R00C1
11101110101010111111
10R010C0101000001E01
10111011101111101101
1000C01000000000R001
11111111111111111111